mission i - operation recon
mission ii - search and destroy
mission iii - broken wing
mission iv - fly by night
mission v - attitude adjustment
mission vi - pair of aces
mission vii - enemy mine
mission viii - one fell swoop
mission ix - egg in your face
mission x - scrambled eggs
mission xi - stiletto heels
mission xii - clipped wings
mission xiii - a pressing engagement
mission xiv - piece of mind
mission xv - a matter of trust
mission xvi - the nemesis
mission xvii - defenses down
mission xviii - time bomb
mission xix - the vultures nest
mission xx - mean machine
mission xxi - never say die
mission xxii - fragments
mission xxiii - troubleshooting
mission xxiv - the spice of life
mission xxv - insinuations
mission xxvi - someone to keep an ion
mission xxvii - remainder zero
mission xxviii - evac-attack!
mission xix - welcome to vultigard
mission xxx -  whiteout
mission xxxi - the javelin
mission xxxii -changing of the guard
mission xxxiii - the model officer
mission xxxiv - vulture mulcher
mission xxxv -  total systems failure
mission xxxvi - a lifetime warranty
mission xxxvii - dead via satellite
mission xxxviii - conflict of conscience
mission xxxix - automation timebomb
mission xl - sole survivors
mission xli - dark side
mission xlii - target practice
mission xliii -
mission xliv - mortality rate
mission xlv -  mine to destroy
mission xlvi - a new face
mission xlvii - deadly defence
mission xlviii - superior firepower
mission xlix - a general nuisance
mission l -  the decoy plot
mission li -  convergence
mission lii - hit or missile
mission liii - a foot in the door
mission liv -  inside out
mission lv -  vendetta
mission lvi - the moment of truth!
mission lvii -  condition critical
mission lviii - conflict of conscience
mission lix - last kill and testiment
